humility	겸손
affirmation	단언. 확인. 확언
austere&nbsp;	엄격한
newfangled	최신의 새로만들어진
homespun humor	plain &amp; simple (소박한)
pragmatism	실용주의
posterity	후세. 후대
pomp	사치. 호화
perks	금전적 혜택
shopkeeping	소매업
lionize	명사 취급을 받다
consummate networker	
rabbi	유대교 지도자
earnestness	진지함. 열심. 진심
basher	혹독한 비판자
bourgeoisie	중산층
conceit	자만심
culminate in	~에 이르다. result in
inscriptions from family tombstones	
persecution	박해
tallow	동물기름
odiferous task	냄새나는
atheism	무신론
debauchery	방탕
profaneness	신성모독
lapidary description	정교한. 상세한
dampen XX's aspiration	꺾다
pious	경건한 독실한&nbsp;
chagrin	원통함. 분함 a feeling of frustrated or annoyed because of failure or diappointment
engrossing	마음을 사로잡는
namesake	이름이 같은 사람
clergy	성직자
puckish	장난끼가 많은
cheeky	건방진. 까부는. rude (showing a lack of respect in a playful and amusing way)
balk at	꺼리다. 멈칫거리다
indenture	고용계약서
versify	시를짓다
postmaster	우체국장
Three of his children was stricken with smallpox.	걸리다
rebut	논박하다
rebuttal	논박. 논증
deism	이신론 (하느님이 우주는 창조했지만 우주는 자체의 법칙에 따라 움직인다는 사상)
conniving	involved in illegal, immoral, harmful thing
disputations	논쟁
precocious	조숙한
sassy	1. 건방진 2. very stylish 3. confident &amp; energetic
laud	찬송. 찬양하다. praise
prudish	얌전한체 하는. 고상한척 하는
encroachment	침해. 침략
spinster	독신녀. 노처녀
knave	정직하지 못한놈
demean	품위를 손상시키다. 위신을 떨어뜨리다
obnoxious	불쾌한. unpleasant
extol	극찬하다
hearty meals	따뜻한. 푸짐한
he became adroit at rationalizing	능숙한
almanac	책력
disheveled	단정치못한
disarming wit	상대방을 무장해제시키는
busybody	참견하기 좋아하는 사람
flaunt	과시하다
incorrigibly capricous	고질적인 = inveterate
foible	약점
cavalier	무신경한
fortify	기운을 돋우다. 강화하다
abstinence	금욕. 자제
infallible	절대틀리지 않는. 확실한
ostracize	추방하다. 외면하다
counterfeit	위로하다
dignitary	고위관리
hapless	unfortunate (불운한)
apostle	주창자
pun	말장난. 말장난하다
get a word in edgyways	남의 대화에 끼어들다. 말참견하다
insinuating	1. 교묘하게 환심을사는. 간사한 2. 의심스러운
indentured servant	계약노동자
encroachment	침략. 침해
convivial	명량한. 우호적인
pounce on&nbsp;	즉각 물고늘어지다
shrill	날카로운
vassal	종속국가
heresies	이교. 이단
a droll irony	우스꽝스러운
circumvent	피하다
partisan	편파적인
titillating	(성적으로) 자극하는
interloper	침입자
amorous	성관계를 원하는. 육욕을 보이는
virility	정력
outlandish	기이한. 이상한
tattle on	고자질하다
inpugn	to criticize by suggesting that someone is not honest or should not be trusted (의문을 제기하다)
regal somebody with something	~을 즐겁게 해주다. 융숭하게 대접하다.
endearing	사랑스러운
dowry	(신부의 신랑의) 지참금
glazier	유리 끼우는 일을 하는 사람
elope	run away secretly to get married
dismissively	경멸적으로
scuttle	무산시키다
bigamy	이중결혼
life imprisonment	
eke out	근근이 살아가다.&nbsp;
plight	역경. 곤경
prosaic	평범한. 단조로운
murky	수상쩍은. 흐린. 어두운
scurrilous	1. 악의적인<div>2. vulgar &amp; evil (천박한)</div>
industry	근면성
industrious	근면한
forsake	그만두다. 버리다
barb	가시돋친말
raucous arguments	소란한 거친
admonish	꾸짖다. 책망하다
censorious	대단히 비판적인
matrimonial	결혼생활의 부부간의
paean	찬가
copious	엄청난. 방대한
a fervent advocate of inocuation	
expound on	~에 대해 상세히 설명하다
revert to	복귀하다. 되돌아가다
polytheism	다신교
stymie	1. to stop (someone) from doing something<div>2. to stop (something) from happening</div><div>He had been stymied in all of his political missions</div>
conundrum	수수께끼. 어려운문제
unnerve	불안하게 만들다.
disciples and detractors alike	제자 (따르는사람) 과 욕하는, 비방하는 사람
venery	성적 쾌락의 추구
overbearing	승훈씨. often trying to control other's behavior in an annoying, unwated way
insolent	rude/impolite
infraction	위반. 안지키는거
folly follies	foolish behavior
inculcate	심어주다 (반복해서)
inexorable	unable to stop or change
scurrilous	said or done unfarily to make ppl have a bad opinion of someone (악의적인)
debility	쇠약
indigence	극빈. 극심한 곤궁 (가난)
aberration	something that is unusual or unexpected. 일탈
pithy	간결하나 함축적인
collegiality	동료간의 협조. 협력
fire brigade	소방원
galvanazing personality	
rugged	1. having a rough/uneven surface 2. strong/determined (rugged individualism)
pseudonym	가짜이름
stickler	꼼꼼한 사람
enumerate	열거하다. enumerate in details (상세하게 열거하다) too many to enumerate (셀수없을 만큼)
fastidious	very careful
hoax	(불쾌한 일에대한) 거짓말
fealty	충성서약
embroil	(언쟁등에) 휘말리게 만들다
diabolical	끔찍한. 악마같은
enthrall	매료하다
vitriolic	harsh &amp; angry words
bigotry	심한편견
forsake	그만두다. 버리다
convulsive	경련적인. 발작전인
exalt	칭찬하다. 승격시키다
piety	경건함. 독실함
companionable personality	다정한
mesmerizing charisma	넋을 놓게 만드는, 최면이 걸리는
pulpit	(교회의) 설교단
haughty	거만한. 오만한
ardent flackery	선전. 홍보
servile respect	굽실거리는
denounce	맹렬히 비난하다
enmity	원한. 증오. 적대감
far-flung	먼, 멀리 떨어진
linient toward/with	관대한
appreciative attitude	
debauch	타락시키다. 유혹하다
pedantic	지나치게 규칙을 찾는. 학자인체하는
usurp	(권위. 권력 등을) 빼앗다. 침해하다
feckless	feckless response (irresponsible, ineffective, weak)
offshoot	파생물
wanderlust	방랑벽
havoc	혼란. 대파괴
beseech	간청하다. 애원하다
entreat	간청하다
orator	웅변가. 연설가
artillery	대포
peremptorily	단호히
raciness	선정적임
acquisitive	소유욕이 많은
envoy	사절. 특사
sweeping	광범위한
eschew	피하다. 삼가다
veneer	허식. 겉치례
gentility	고상함. 품위. 고풍스러움
ambivalent	양면적인. 애증이 엇갈리는. 반대감정이 상존하는
beckon	(오라고) 손짓하다. 유혹하다
catheter	체내에 삽입해서 소변등을 뽑아내는 도관
bastion	요새
oratory	웅변술
temperately	적당하게. 알맞게
penchant	애호. 기호
thwart	좌절시키다
flighty	변덕이 심한
provost	학장. 교무처장
conniving	given to or involved in conspiring to do something immoral, illegal, or harmful (교묘하게)
matching grant	
circumspect	think carefully about possible risks before acting (신중한)
cosmopolitanism	범세계주의
empirical	경험에 의거한. 실증적인
espouse	옹호하다. 지지하다
preclude	(~하지) 못하게 하다. 불가능하게 하다
pejorate	change for the worse (악화시키다). Slaves pejorate the families that use them
decry	매도하다. 욕하다
assemblyman	주의회의원
insinuate	1. (환심등을) 사다. 2. (불쾌한일을)암시하다.
quintessence	the most perpect or typical example. 전형. 진수
pacifist	평화주의자
at oddes with	뜻이 안맞다. 상충하다
proprietary colony	독점식민지
proprietary rights	소유권
proprietary	등록상표가 붙은. 소유주의
parochial	지역주의의. 편협한. nonparochial (반대말)
whopping	엄청큰
bacchanal	술을 마시며 떠들어대는 (잔치)
estrange XX from	~로부터 멀어지게하다. 이간질하다
invigorate	활성화시키다
haphazard	닥치는대로의, 되는대로
recalcitrant	(규칙. 지시에) 저항하는
instigation	선동. 부추김
covenant	약속. 서약
ally	동맹국. 협력자
It was to no avail	
shelve	보류하다
prerogative	특혜. 특권
subservient	굴종하는. 영합하는 (subservient to)
entrancing	넋을 빼앗는, 황홀하게 하는 an entrancing woman
amorous	성관계를 원하는. 육욕적인. 색을 밝히는
consummate	첫날밤을 치르다
conjurer	마술사. 아주 영리한 사람
&nbsp;relish	즐기다
sugarplum	알사탕
roguish	악동같은
ardor	열정. 정열
tantalizing	<div>torment or tease with the sight or promise of something that is unobtainable</div>eg) tantalizing flirtation (감질맛나게하는. 애타게하는)
invoke	들먹이다. He invariably invoked Deborah's name (whenever he flirted with women)
rebuff	퇴짜. when he was rebuffed
bequeath	물려주다. 기증하다. 유증하다
exhortation	권고. 훈계. 장려
lecherous	색을 밝히는. lecherousness (호색)
astute	약삭빠른. 영리한. 빈틈없는
dissident	반정부인사. 반체제 인사
I was pleading people for help	
tussle	몸싸움
dazzling	눈부신. It was a dazzling morning
gibberish	횡설수설. a chalkboard filled with gibberish
ensconce	to firmly place or hide (자리를 잡다. 숨다)
We felt welcome in China	
relish	즐기다
Gorbachev	
repression	China was surving on repression rather than legitimacy
pacifier	고무젖꼭지
ferociously	dogs growled ferociously
confiscate	몰수하다
seethe	분노하다. I seethed when I heard that
inundate	침수시키다
shackle	족쇄
toil	(장시간) 힘들게 일하다. 노역, 고역
sovereignty	통치권. 자주권. 자주 unlimited power over a country: a country's indepent authority and right to govern itself
hoodlum	깡패. 불량배
bespectacled	안경을쓴
ambivalence	양면성. 이중성
edgy	edgily 초조해하는 불안한
fortify	강화하다. 요새화하다
revoke	폐지하다. 취소하다
rearview mirror	
correspondent	기자. 특파원
topsy-turvy	topsy-turvy experience (온통뒤죽박죽인. 혼란스런)
He still walks with a limp	
evict	쫓아내다
churn something out	대량으로 만들어내다
suspend	유예하다. 연기하다
leery	의심쩍어하는. 경계하는 (They're leery of foregin joiurnalists)
felicity	1. 더할 나위없는 행복 2. 절묘하게 어울림. 아주 적절한 표현
dalliance	1. 시간낭비 2. (성적으로) 놀아남.flirting<div>dalliance with Caty Ray</div>
obstruct	막다. 방해하다&nbsp;
patriotism	애국심
profusely	아낌없이, 풍부하게 profusely commended
commend	칭찬하다
fissure	깊게 갈라진 틈
prevail	1. 만연하다 2. 승리하다/이기다 23. 설득하다<div>prevail on somebody to do something ~하도록 설득하다</div>
rout	완패시키다. The British army was ambushed and routed.
calamity	재난. 재앙
imposition	(새로운 법률, 세금등의) 시행. 도입. 도입하다
abhorrent	혐오스러운. 혐오감을 자아내는 abhorrent to (~에게 있어서 불쾌한)
enrage	격분하게 만들다
grudgingly	&nbsp;마지못해
distressing	괴로운. 고통스러운. 비참한
parlay	1. 활용하다 2. 늘리다 Parlay his popularity into political power. Parlay a small investment into a fortune
vancor	원한. 앙심
dexterous	비상한. 솜씨좋은. 능란한 dexterous politician
respite	(곤경. 불쾌한일의) 일시적 중단. 유예
obstinacy	완고함. 고집
sanguine	낙관전인. 자신감이 넘치는
roil	휘젓다
wake	배가 지나간 자리&nbsp;
inquisitive	꼬치꼬치 캐묻는.탐구심이 많은. 호기심이 많은
avuncular	삼촌같은
how the moon affects tidal flows	
prodding	재촉. 촉구
reprehension	질책. 비난
injunction	명령. 경고
transgress	(도덕적. 법적 한계를) 넘어서다/어기다. transgress morality 도덕을 어기다
peripatetic	이동해다니는
assuage	누그러뜨리다 assuage my guilt. assuage her grief
bereft	상실감에 빠진
stratify	층을 이루게하다. 계층화하다
wayward	behave in a way that's not socially acceptable
burgeoning	급증하는. 급성장하는
verbatim	말그대로의 repeat verbatim (말그대로 따라하다).&nbsp;<div>He wrote the conversation down verbatim</div>
countenance	1) 얼굴표정<div>2) to accept, support, or approve</div>
vexation	성가심. 짜증
gibbet	교수대
solicitous	세심히 배려하는, 염려하는 showing convern or care&nbsp;
indisposed	아픈, 몸이 좋지않은
fitful	잠깐씩 하다가 마는 filful sleep (자다 깨다하며 자는잠)
repute	평판. 명성
unfazed	동요하지 않는
genealogy	족보. 계보 genealogical (족보의)
inviolable	침범할수 없는
pliant	말을 잘듣는, 순종적인
expedient	편리한, 임기응변의, 방편/방칙 temporary expedient (임시방편)
libel	명예훼손
adjourn	(재판. 회의등을) 중단하다. 휴정하다
treatise	논문
berate	<div>criticize. yell at &nbsp;질책하다</div>
lament	슬퍼하다. 애통하다
pawn	볼모. 인질
prevail	1. 만연하다 2. 이기다/승리하다
surreptitiously	몰래. 은밀하게
approbation	praise or approval. &nbsp;self-approbation (자화자찬)
dissipate	소멸되다. 없어지다
tractable	1. 온화한, 다루기쉬운 2. willing to learn or guided by others
stead	대신. 대리 In Deborah's stead, he took his daughter, Sally.
full-fledged	1. fully develped 2. meeting all the necessary requirements<div>A full-fledged social and religious civil war</div>
mangle	심하게 훼손하다
hatchet	손도끼
grievance	불만(사항)
inveterate	1. 고질적인, 뿌리깊은 2. 상습적인<div>an inveterate smoker (상습적인)</div><div>an inveterate disease (고질적)</div>
tyranncial and inhumane	
vitriolic	독설에 찬 harsh and angry words
surrilous	악의적인. 천박한
cacophony	불협화음
delirious	1. 의식이 혼미한 2. 기뻐서 어쩔줄 모르는<div>eg) he was delirious from fever, shock, and low oxygen levels.</div>
agent provocateur	정부공작원
plea	간청
provenance	유래. 출처
tribune	민중지도자
fleeting	순식간의, 잠깐동안의
populace	대중/민중
imbibe	흡수하다
bristle	become angry
equivocation	얼버무리기<div>answer without equivocation (똑똑히 답장해)</div>
sardonic	비웃는. 조소하는, 가소롭다는듯한
maim	불구로 만들다
debacle	대실패. 큰낭패
balwark	방어벽. 보호자
repeal	(법률을) 폐지하다. 취소하다
enact&nbsp;	enact laws 제정하다
odious	혐오스러운
insinuation	bad or insulting remark in an indirect way (중상. 비방)
acrimony	악감정
plaintively	구슬프게, 애처롭게, 하소연하듯이
versaille	베르사유
insinuating	1. winning favor and confidence by imperceptible degree (교묘하게 환심을 사는)<div>2. tending gradually to cause doubt/trust (의심스러운)</div>
burlesque	풍자시
subjugate to	종속시키다. 지배하에 두다
surmise	guess
trepidation	두려움
I resolved to go	
salt-and-pepper hair	희끗희끗한 머리
impoverished peasants	
He was shorter than I by a head	
I sifted through the piles of documents	
papers I was rummaging through	뒤지다
Tianamen Square Democracy Movement	
unequivocal	애매한, 모호한
manacle	수갑
go astray	잘못된 방향으로 가다
pudgy	땅딸막한
unkempt	헝클어진, 단정치못한
counterevolution	반혁명
expunge	삭제하다. communist try to expunge from the history
hard-liner	강경파
impetutous	<div>acting or done quickly without thinking: contolled by emotion that thoughts</div>성급한, 충동적인
fatuous	어리석은, 얼빠진
sooty	그을음진<div>The paint on the ceiling was sooty and chipped</div>
innocuous	not harmful or offensive
insidious	causing harm in a way that is gradual or not easily noticed
fortnight	2 weeks
obscurity	state of being unknown or forgotton<div>adj. obscure</div>
emulate	to try to be like (someone or something you admire) 모방하다<div>eg) emulated the pretensions of the well-born elite</div>
raconteur	someone who's good at story telling
insouciance	a relaxed and calm state. a feeling of not worring about anything
delve	to make a careful/detailed search for info<div>delve into simple lessions</div>
lucidity	clearness of thought or style
homespun	plain &amp; simple
a self-made man	
albeit	even though
in absentia	부재중
distress	1. unhappiness or pain<div>2. very difficult situatio</div><div>verb: to worry or upset</div>
nemesis	opponent / enemy
enviable	desirable
unfounded	not based on facts or proof
chastise	criticize= berate
prodigality	carelessly and foolishly spending money, time, etc. 낭비, 헤픔
debunk	to show that something is not true, something is false
complete abolition of slave ownership	
baffle	confuse
I grow homesick	
tempest	a violent storm
surreptitious	done in a secret way
orgy	a wild party (often involving sex)
dissolute	dissolute friends (방탕한)
cockpit	조종석
purloin	훔치다
ostensible	표면상의 (사실은 다르지만)
undermine	weaken, make less effective
invective	insults / abuse eg) invective against me
contrite	feeling or showing regret for bad habavior<div>깊이 뉘우치는, 후회하는</div>
ruminative	심사숙고하는. 곰곰이 생각하는
confidant	a trusted friend
chide	scold gently
restitution	배상. 보상
emancipation	해방
petulant	심통부리는 (맘대로 안될때)
vehement	showing strong, angry feeling (분노로) 격렬한
thugocracy	여러 폭력단체의 국가
frumpy	유행에 안맞는 옷차림의
thermos	
menacing	위협적인, 해를 끼칠듯한
brash	자신만만한, 건방진
remorse	
I'm rooting for him	
bushy eyebrows	
fulsome	지나친 (overdone): expressing in a very enthusiastic or emotional way
self-abnegation	자기희생
confucianism	
atheist	
agnostic	
Nobody dares complain	
disgunted peasants	
aquiescent	동의하는. 묵인하는
infiltrate	잠입하다. 침투하다
She was sterilized	불임수술을 하다
a man in tattered clothes	
espionage	스파이행위. 방첩활동
mutilate	훼손하다. the body was mutilated
mind-boggling	상상이 안되는, 놀라운, 이해할수 없는
octogenarian	80-90살 노인
IOU	written promise to pay a debt
avaricious	탐욕스러운. 욕심많은
gallop	질주하다. 전속력으로 달리다
clans	씨족
ubiquitousness	만연함 the ubiquitousness of the corruption<div>adj. ubiquitous (어디서나 있는, 아주흔한)</div>
graft	부정이득
kleptocrats	약탈형 정치가
in their eleventh hour	막바지에
cadre	간부단
crook	사기꾼
by sentencing him to life imprisonment	
bribery and avarice	
impossible to uproot	
vehemently	격력하게 deny vehemently
brothel	사창가집
gangly	tall &amp; thin
frail	약한, 부서지기 쉬운
on a wintry day	
The thought gnawed at me	괴롭히다
castrate	거세하다
That got me thinking	
I admire him enormously	
Tears welled in my eyes, and his voice caught.	
retinue	(중요인물의) 수행요원
Dad didn't dare say anything	
gaunt	수척한
famished	굶다
gag	재갈, 입마개
I pounded on the door	
haggle	실랑이를 벌이다. 입씨름하다
My anger toward Fei was ebbing.	
leprosy	나병, 문둥병
consummation	첫날밤 치르기
sodomy	anal sex
inkling	짐작, 눈치<div>Do you have any inkling?</div>
impish	버릇없는. rude
chain-smoke	줄담배피다
hick	시골뜨기. 촌놈
the income gap is widening	
standard of living is rising steadily	
inoculate	inoculate their children against disease
Filipinos / Philippines	
"Mao - ""Great Leap Forward"" 1958"	
scathing	혹독한, 뼈아픈 (very harsh or severe)&nbsp;<div>eg) scathing comment, scathing criticism</div>
government bureaucrat	정부관료
laissez-faire	자유방임주의의
bustling	부산한, 북적거리는
ogre	사람을 잡아먹는 귀신
incredulous	not able or willing to believe: feeling or showing a lack of belief<div>eg) I asked incredulously</div>
economic sclerosis	경화
dilapidated	허물어져가는
atrocious	1) very bad 형편없는 eg) Her Enlgish is atrocious<div>2) very evil or cruel</div>
falter	1) begin to fail/weaken<div>2) walk/move in an unsteady way</div><div>3) to feel doubt about doing something</div>
abscessed	종기가 생긴 abscessed teeth
midwife	조산사
bashful	수줍어하는
China's economic boom	
gleefully	merilly
skirmish	a brief and usually unplanned fight during a war
loquacious	liking to talk 말이 많은
artifice	책략. 계락 (숨겨진, 인위적인) Franklin's artifice of silence
bide	(알맞은) 때를 기다리다.<div>eg. bide your time</div>
rancor	an angry feeling of hatred or dislike
dissipation	becoming less and disappearing
chafe	1) to become irritated or annoyed:&nbsp;<br /><div>eg) chafe at ~에 짜증나다 Franklin chafed at authority</div><div>2) (피부가) 쓸리다</div>
legislature	입법부
perfidy	betray someone: sate of not being loyal
irksome	annoying / irritating
delusive	giving a false or misleading impression
lank	tall and thin with usually in an awkward way
headlong	곤두박질쳐서. 거꾸로
befit	걸맞다
nepotism	친족등용
septuagenerian	70대 노인
mutiny	반란
disparaging	얕보는. 폄하하는. 험담하는<div>disparage: to describe (something/someone) as unimportant, weak, bad, etc.</div>
bisiege	에워싸다. 둘러싸다. 포위하다
hospitable	환대하는, 친절한
gout	통풍
abomination	혐오하는것
in hindsight	지나고보니까
scripture	성서
akin to	similar to
allegiance	충성
cadence	&nbsp;억양
melliflous	having a smooth, flowing sound
propound	세우다<div>eg) natural right propounded by John Locke</div>
retort	쏘아붙이다. 응수하다. 반박하다
peruse	정독하다
resounding	providing a lound, deep sound that lasts for a long time
felicitous	very well suited.&nbsp;
eviscerate	to take out internal organs (of an animal)<div>eg) Large sections were eviscerated.</div>
distraught	very upset (제정신이 아닐 정도로)
ratify	to make official signing it / voting for it 승인하다
Declaration of Independence	
rebuke	v. speak in an angry/critial way&nbsp;<div>noun 도 됨</div>
insurrection	반란
adroit	능숙한
resurrect	부활시키다
mercenary	용병
deluge	폭우<div>deluge our settlements with blood</div>
poignancy	신랄. 날카로움
parole	가석방하다
renunciation	포기<div>eg) renunciation of independence</div>
farcical	웃음거리가 된, 익살맞은
mutton	양고기
aggrieve	고통을 주다. 괴롭히다
cajole	꼬시다. 회유하다. 구슬리다
cantankerous	often angry &amp; annoyed: quarrelsome: crabby<div>성미가 고약한, 불평을 달고사는</div>
callous	냉담한
farlorn&nbsp;	sad and lonely<div>eg) farlorn wife</div>
frivolous	silly and not serious<div>trivial</div>
anonymity	익명성
to the hilt	최대로, 최대한
dexterity	재주. 솜씨
avenge	복수하다
equanimity	평정.침착
sticky fingers	좀도둑질
vituperative	욕하는, 독설을 퍼붓는
stipend	봉급, 수당
shrewd	mentally sharp, clever
opulent	very wealthy 엄청나게 부유한
gambit	수. 책략 (대화등의 초반에 우세를 확보하기 위한 수)
asylum	1. 망명 2. 정신병원
scurry	to move quickly with short steps<div>종종 걸음치다. 총총가다</div>
cloistered life	seperated from the rest of the world
vivacious	happy and lively in a way that's attractive<div>noun. vivacity&nbsp;</div><div>명량한. 쾌활한</div>
comptroller	미국 통화/회계 감사원장
acolyte	시종
frivolity	"noun form of ""frivolous""<div>lack of seriousness: being silly&nbsp;</div>"
circumspection	thinking carefully about possible risks before action 세심한 주의, 용의주도함
When the candles flickered out	
vagary	an erractic / unpredictable action or change<div>eg) Benny also felt the vagaries of Franklin's affection</div>
indolent	not liking to work or be active&nbsp;<div>나태한, 게으른</div>
nither gaiety nor vivacity	
flog	beat or whip severely
exonerate	무죄가 되다. 면제하다
beleaguered	사면초가에 몰린, 포위된 (caught in troubles)
vindictive	앙심을 품은, 보복하려는<div>having a strong desire for revenge</div>
reparation	(국가가 지불하는) 배상금
unilaterally	단독으로, 일방적으로
belittle	to describe as little or unimportant<div>하찮게 만들다. 비하하다</div>
tacit	expressed or understood without being directly stated<div>암묵적인</div>
coy	1) having a shy or sweetly innocent quality that is often intended to be attractive or to get attention<div>2) not telling ore revealing all the info</div><div>eg) feminine coyness is very common among animals</div>
languish	머물다. (오랫동안 불쾌한 일을) 겪다
antipathy	a strong feeling of dislike
bantering	정감어린
tonic	강장제<div>travel was a tonic rather than travail for Franklin</div>
travail	고생. 고역
replete with	fully, abundantly filled with
garrulous	very talkative: tending to talk a lot<div>eg) the garuulity of an old man has got hold of me (Franklin)</div>
prodigious	(놀라움. 감탄을 자아낼 정도로) 엄청난<div>amazing or wonderful: very impressive: very big</div>
an ingenious man if not genious	
huzzah=huzza	hurray
acclamation	strong and enthusiastic approval or praise<div>환호. 갈채</div>
grandpapa	
grandchildren	
edify	to teach in a way that improves the mind or character<div>교화하다. (의식을) 고양시키다</div>
edifying	의식 고양적인, 교화적인
squirm	make lots of twisting movements because you're nervous, bored, uncomfortable, etc.<div>꿈틀거리다.&nbsp;</div>
squirm out of	벗어나다
dote on	맹목적으로 사랑하다. 애지중지하다
squander	낭비하다.
augment	늘리다. 증가시키다
doddering	(특히 나이가 많아서) 움직임이 자유롭지 못한
unassuming	잘난체 하지않는<div>Franklin's unassuming style</div>
repository	저장고. 보고
impeach	탄핵하다
vindicate	1. show that someone is correct, true, or reasonable<div>2. show that someone is not guilty</div>
despotism	폭정
expediency	1. suitability, fitness<div>2. a means of achieving a particular end (방편, 수단)</div>
taut	firm and strong: very tense
sneer	a smile or laugh at someone with an expression of dislike or lack of respect on your face: to express dislike and lack of respect in a very open way 비웃다. 경멸하다
pope	the head of Roman Catholic church
lexicographer	사전편찬자
ameliorate	to make things better, less painful, etc.<div>개선하다</div>
pernicious	causing harm/damage in a way that's not easily seen or noticeable<div>치명적인. 악의에찬</div>
superintend	to direct or manage
sanction	to officially accept or allow
amorphous	having no definite or clear shape of form 확실한 형태가 없는
virulent	extremely/excessively harsh or strong = malicious<div>eg) virulent attack 매서운. 치명적인. 악성의</div>
Providence	(capitalized) divine guidance or care
memento	something that's kept as a reminder of a person, place, or thing
bequeath	1. 물려주다. 유증하다<div>2. go give (ideas, knowledge, etc.) to (younger ppl) as part of their history 남기다</div>
dither	to delay taking action because you're not sure about what to do
bequest	유산
divvy	divide / share
unbashed	not embarrased or ashamed about openly expressing strong feelings or opinions
rubbish	쓰레기
heap	더미
udder	젖통
shirk	회피하다. 기피하다
hoist	들어올리다.&nbsp;<div>eg) hoist the flag</div>
literate	
bleat	(염소) 매애하고 울다
wean	젖을 떼다<div>eg) as soon as they were weaned</div>
windfall	우발적인 소득. 뜻밖의 횡재
murmur	투덜거리다
irrepressible	1. 억누를수 없는 2. 활력이 넘치는
restive	가만히 못있는<div>eg) in a restive mood 들뜬 기분으로</div>
eloquence	웅변, 능변
uneasiness	불안, 걱정, 어수선함
trotter	(돼지) 족발
gale	강풍
malignity	악의. 원한
ignominious	수치스러운, 창피한 (causing disgrace or shame)
decreed	<div>n. an order usually having the force of law (명령. 칙령)</div>v. 명하다. 공포하다
menace	위협.협박. 위협하다
lurk	to lie in wait in a place of concealment especially for an evil purpose 숨어있다. 잠복하다.
slay	죽이다. 살인하다 kill<div>eg) they were all slain on the spot</div>
expulsion &nbsp; expel	축출. 축출하다. 쫓아내다.&nbsp;
treachery	배반
retribution	punishment for doing something wrong<div>(강력한) 응징</div>
I was taken aback	놀라다
cockerel	어린 수탉
hullabaloo	웅성거리는 소리
sentinel	보초병<div>eg) stand sentinel</div>
ecclesiastical	of or relating to the Christian church or clergy
foreordain	미리 정하다. 미리 운명을 정하다<div>to dispose or appoint in advance</div><div>eg) Man of foredained with reason yet not foredained to use it.&nbsp;</div>
nefarious	evil or immoral<div>eg) nefarious, anti-American ministers</div>
verse	versify<div>eg) Jefferson's service in the Congress in 1776 left him thoroughly versed in the ways and means of politics</div>
exult	to feel or show great happiness 크게 기뻐하다
exultant	very happy and excited<div>eg) exultant about</div>
diminutive	very small
assiduous	showing great care, attention, effort.&nbsp;<div>근면성실한, 힘을 쓰는</div>
declamation	to say something in a loud and formal way<div>열변을 토함. (의견이나 감정을 강력히 피력한 연설, 웅변)</div>
apostolic	relating to the pope
dire	very bad: worrysome: very urgent: requiring immediate action
extricate	(곤란한 상황에서) 해방시키다. 탈출시키다<div>to free from difficult situation</div><div>eg) extricate a person from dangers</div>
resilient	1. able to become strong, health, successful again after something had happens<div>2. able to return to an original shape after changing forms</div>
Like her husband, she had a perfectionist streak.	
pledge	v. to formally promise to give or do (정치)<div>n. a serious promise or agreement</div>
bounty	포상금
infantry	보병대 (fight on foot)
despondent	very sad and without hope (낙담한, 실의에빠진)
rendezvous	만날약속, 만남 (secretly)
relinquish	포기하다. 양도하다
exculpate	to prove that someone is not guilty<div>무죄를 입증하다</div>
derelict	failing to do what should've been done (무책임한, 임무 태만의)
aspersion	a false or misleading charge meant to harm someone's reputation<div>- the act of making such a charge: defamation</div>
He believed himself a failure	
vigil	밤샘간호
abstract	v. remove. seperate
swoon	1. faint (기절하다)<div>2. to become very excited about something</div><div>eg) swooning with joy</div>
Thomas Jefferson was accustomed to public success and popular praise.	
His beloved wife had died	
wanting	not having all that's needed or expected<div>~이 부족한. (질적인 면에서) 부적합한</div><div>eg) People thought Jefferson's leadership had been found wanting.</div>
No great life was without its mishaps and its mistakes.	mishap (a small mistake or amount of bad luck). 작은 사고, 재수없는일
anarchy	무정부상태
quorum	(의사결저에 필요한) 정족수
usurpation	왕위찬탈
inflammability	가연성. 연소성
abate	to become weaker: to decrease<div>eg) Jefferson's scientific curiosity never abated</div>
tutelage	지도. 교육. teaching by a teacher: helpful influence or guidance
admonition	a criticism or warning
deplorable	very bad in a way that causes shock, fear, or disgust<div>끔찍한</div>
recoil	(무섭거나 불쾌한 것을보고) 움찔하다. 움츠러들다
baroness	남작부인
voluptuous	very attractive because of having large lips and breasts
commotion	소란. 소동
forbearance	관용. 자제
fainthearted	용기없는. 심약한. 겁많은. 베짱없는. feeling or showing a lack of courage
fretful	조바심내는. 조마조마해하는 (not relaxed or restful: upset &amp; worried)
tyrant	
hyperbolic	1. 쌍곡선의 2. 과장된. 과장법을쓴
earthbound	1) 지상에 묶여있는 2) lack of imagination
daunt	to make someone afraid or less confident<div>eg) Jefferson was duanted.</div>
Jefferson feared failure and disapproval.	
scrupulous	very careful (세심한. 꼼꼼한)
wrath	extreme anger
demur	이의를 제기하다.<div>disagree with another person's opinion/suggestion</div>
supercilious	haughty
absolve	무죄임을 선언하다. (죄를) 용서하다
allude to	암시하다. 넌지시 시사하다. 말하다.&nbsp;<div>to make indirect reference (직접 말하는것: refer to , mention)</div>
Direct conflict was unproductive and ineffective.	
vitriol	독설
fray	싸움. 소동
egregious	very bad and easily noticed<div>eg) egregious&nbsp;[sound:rec1437882913.mp3]</div>
sedition	폭동 선동.&nbsp;<div>the crime of saying, writing, or doing something that encourages ppl to disobey to their gvmt</div>
indict	기소하다 to charge with a fault or offense
harangue	열변을 토하다. 장광설을 늘어놓다<div>v. to speak in a forceful or angry way</div><div>n. a scolding speech or writing</div>
hitherto	until now. before this time
calumniate	<div>=slander. 비방하다. 중상하다&nbsp;</div><div>n: calumny</div>
commemorate	기념하다
somber	1. very bad and serious<div>2. having a dull or dark color</div>
indisposition	a slight illness
credence	신빙성. 믿음
calumny &nbsp;calumnies	<div>an untrue statement made to damage someone's reputation: and act of doing so&nbsp;중상. 비방&nbsp;</div><div>= slander = aspersiong = calumniation = libeling = defamation</div>
judiciary	사법부. 법관들
chief justice of US	수석재판관
capitulation	조건부항복. 굴복
bigoted	편견이 아주심한
Jefferson quietly exulted at the outcome of the election	
exhilarated	happy &amp; excited
heartfelt	진심어린
agrarian	농업의
vengeance	복수
entrance	to fill someone with delight and wonder<div>eg) entranced : delighted with wonder</div>
congenial	pleasant and enjoyable: very friendly
disdain	v. (수치스러워서) 거부하다. 업신여기다. 경멸하다<div>n. 경멸, 무시 dislike, disapproval</div>
deft	1. skillful and clever<div>2. able to do something quickly and accurately</div>
Jefferson noticed a buzzing fly and deftly reached out and snatched it out of the air.	
schism	분열
insatiable	always wanting more. not able to be satisfied
coalesce	(더 큰 덩어리로) 합치다. 협동하다
ordain	(성직자로) 임명하다
propensity	경향. 성향
spurn	reject disdainfully
truce	휴전
mobocracy	폭민정치
diatribe	혹평. 비판
It was a characteristic Jeffersonian tactic, instigating a course of action from afar.	
acquittal	무죄판결
intrigue	1. a secret plan (모의, 음모)<div>2. to make secret plans (모의하다. 음모하다)</div><div>3. 관심을 끌다</div>
remonstrance	항의. 불평
scathing newspaper attack	harsh/strong
refutation	논박. 반증
affliction	something that causes pain/suffering 고통
bungle	그르치다. 망치다
govt	government
recant	to publicly say that you no longer have an opinion or belief you once had
vociferous	expressed in a very loud and forceful way
enigmatic	full of mystery and difficult to understand<div>= mysterious</div><div>eg) the Mona Lisa's enigmatic smile</div>
denigrate	폄하하다. = belittle = disparage = discount
anthropomorphic	의인화한<div>eg) anthropomorphic personification</div>
impute to	to blame (~의 탓으로 돌리다, ~에게 돌리다. 전가하다. 씌우다)
didactic	교훈적인, 가르치려드는
quaint	odd
neo-Darwinism	new
laconic	using few words in speech or writing
full-throated	크게 (목청껏) 소리치는
pervade	to spread through all parts of something<div>만연하다. 구석구석 스며들다</div>
The chimpanzee and the human share about 99.5 per cent of their evolutionary history.	
layman	비전문가. 평신도
gripping	to hold the interest of strongly<div>eg) a story that grips the reader</div>
unstinting	give in a very strong and generous way&nbsp;<div>아낌없이 주는</div>
unerring	always right and accurate: make no errors
tenable	capable of being defended against attack/criticism<div>eg) a tenable theory</div><div>&nbsp; &nbsp; &nbsp; a tenable position</div>
corollary	result<div>eg) as a corollary to = as a result&nbsp;</div>
baboon	개코원숭이
pounce	(공격하겨나 잡으려고) 덮치다.
macabre	섬뜩한 (죽음과 관련해서)<div>eg) macabre cannibalism of female praying mentises</div>
copulate	to have sexual intercouse
kamikaze	죽을줄 알면서도 적을 향해 돌진하는
reap	거두다. 수확하다
the commonest and most conspicuous acts of animal altruism	
euphemism	a mild or plesant word or phrase that is used instead of one that is unpleasant or offensive<div>완곡어구</div><div>eg) 'perpetuation of species' is a common euphemism for reproduction</div>
buttress	support, strengthen
countenance	verb: to accept, support, or approve
foetus	= fetus 태아
amoeba	
antelope	영양
vertebrates	척추동물
stot	"껑충껑충 뛰다<div>eg) ""stotting"" in Thomson's gazelles</div>"
analogous to	유사한
Darwin's 'survival of the fittest'	
spherical	구의 having the shape of a sphere<div>eg) soap bubbles tend to be spherical</div>
atoms -&gt; molecules	
droplet	작은 (물)방울
ultraviloet	자외선의
unmolested	방해받지 않는
affinity	친밀함
pervert	왜곡하다<div>to change (something good) so that it's no longer what is was or should be</div>
willy-nilly	좋든 싫든 (상관없이)<div>eg) Evolution is something that happens, willy-nilly.</div>
tortuous	1) having many twists &amp; turns<div>2) complicated, long, and confusing</div>
nucleotide	DNA molecules are chains of nucleotides
nucleus	세포핵
chromosomes	염색체. 46
gregarious	1) enjoying the company of other people<div>2) biology: tending to live in groups</div>
intricacy	복잡한사항. 복잡함
analogy	비유. 유사점
The 46 chromosomes consist of 23 pairs of chromosomes	
recessive	열성의, =/ dominant
allele	대립형질 (when two genes are rivals for the same spot on a chromosome)
mitosis	유사분열
meiosis	감수분열
point mutation	점 돌연변이
inversion	도치
mimicry	흉내. 모방
oblivion	1) state of not being remembered<div>2) state of being unconcious or unaware</div>
gene: largest entity which has properties of longevity, fecundity, and copying-fidelity	
oarsman	(팀의 한사람으로서) 노젓는 사람
cox	키잡이
deleterious	해로운. 유해한<div>deleterious genes[sound:rec1437926104.mp3]</div>
propagate	1. to make something (idea or belief) known to many ppl 전파하다<div>2. (식물을) 번식시키다 to produce a new plant</div>
mitotic	유사분열의
elm trees	느릅나무
purposive purposiveness	목적이 있음
oscillate	1. (두지점사이를) 왔다갔다하다<div>2. (감정, 행동이 양극을) 계속 오가다</div><div>3. 진동하다</div>
postulate	to suggest (an idea or theory) especially in order to start a discussion 상정하다
constellation	a group of stars that forms a particular shape in the sky and has been given a name<div>별자리</div>
camouflage	
maddening	<div>tending to infuriate: very annoying</div>열받게 하는, 미치게하는
pang	a sudden, strong feeling of physical or emotional pain
remission	1. 감면 reducing/canceling the amount of money that you owe<div>2. (병의) 차도</div>
scurrility (scurrilities)	상스러움. 천박함<div>adj. scurrilous (1. vulgar &amp; evil 2. 악의적인)</div>
eulogize	extol 칭송하다
belie	1. to show to be faulse or wrong (거짓임을 보여주다)<div>2. to give faulse idea of</div>
meteor	유성. 별똥별
telltale	숨길수없는<div>eg) telltale headache was back</div>
debilitate	심신을 약화시키다<div>eg) His headache was debilitating</div>
culprit	범인
secede	분리독립하다
scoundrel	악당
drudging	long, difficult, or unpleasant work
repugnant	causing a strong feeling of dislike or disgust<div>불쾌한, 혐오스런</div>
embargo	통상금지령
euthanasia	안락사<div>v. euthanize</div>
precipitate	1. to cause something quickly or suddenly<div>2. become seperated from a liquid by a chemical process&nbsp;</div>
indignation	분개. 분함 (anger caused by something unfair or wrong)<div>= anger, fury, rage, wrath</div>
levee[sound:rec1437882604.mp3]	대통령 접견회
The president gave the order unilaterally, without congressional approval	
depredate	약탈하다. plunder<div>n. depredation</div>
disavowal	부인. 부정
procrastination	
breathtaking	very exciting or thrilling: very great or surprising
compound	1. to make things worse<div>2. pay interest on principal + earned interest</div><div>3. to form by combining seperate things (혼합하다. 조합하다)</div><div>eg) the pain in his jaw compounded the stress he was feeling</div>
reprisal	보복. 앙갚음
meddlesome	간섭하기 좋아하는
meddle	간섭하다
salutary	producing a beneficial effect<div>유익한, 효과가 좋은</div><div>eg) The embargo is salutary. It postpones wars, gives time, etc.</div>
heat apoplexy	일사병 (sunstroke)
apoplexy	뇌졸증. 중풍 (stroke). medically는 잘 안쓰임<div>apoplectic: furious and redfaced with uncontrollable rage</div>
apoplectic	furious and redfaced with uncontrollable rage<div>eg) my parents were apoplectic when they saw my grades (often used humorously)</div>
apostasy	배신. 변절<div>eg) John Quincy Adams should've his head taken off for his apostasy to the Federalists.</div>
impregnable	난공불락의
referendum	국민투표
diseased	질병에 걸린, 병을 앓고있는
exfoliate	벗겨내다. 박리하다
boisterous	very noisy and active in a lively way 활기가넘치는 떠들썩한
accolade&nbsp;	accolades&nbsp;<div>: an award or an expression of praise&nbsp;</div><div>칭찬, 포상</div><div><div><br /></div></div>
tribute	something done, said, or given to show respect, gratitude, or affection<div>eg) Still, accolades and tributes arrived regularly.</div>
Madison's success was a vindication for Jefferson - a tangible sign that the country approved of his basic vision and stewardship.	
stewardship	careful and responsible management
inaugural	of inauguration
entourage	(주요인물의) 수행단 = retinue<div>eg) His correspondence and reading were varied and voluminous.</div>
alcove	a small section of a room that is set back from the rest of it
before bedtime	
bust	흉상. 반신상
parlor	응접실. 객식<div>a room used for conversation or for spending time with guests</div>
octagonal	8각형의
patriarch	족장. 원로
resumption	v. resume
There is a tranquility about him, which an inward peace could alone bestow.	
ineffable	"형언할수 없는&nbsp;<div>too great, powerful, beautiful, etc.</div><div>eg) He loved, he said, the ""ineffable luxury of being owner of my own time.""</div><div><br /></div>"
unsparing	very harsh or severe
reputed	~라고 알려져있는 (평판이난)<div>well-reputed: 평판이 좋은</div><div>his reputed father: 그의 부친이라 일컬어지는 사람</div>
&nbsp;clandestine	done secretly (비밀리에 하는, 은밀한)
incarnation	1. spiritual entity manifested into a physical body<div>2. 화신 a concrete or actual form of a quality or concept&nbsp;</div><div>eg) she is the incarnation of goodness</div><div>3. (특별한 형태로 사는) 생애</div><div>eg) in a previous incarnation</div>
oncology	종양학
indiscernible	impossible to recognize: impossible to see, hear, or know exactly
fumble	1. 더듬거리다<div>2. make awkward attemp to do or find something</div><div>3. sport: failt to catch or hold the ball (헛발질하다)</div><div>eg) fumble an attempt 어설프게 시도하다</div><div>eg) fumble with= handle clumsily</div>
migraine	편두통
ebullient	lively and enthusiastic<div>eg) outgoing, gregarious, and ebullient</div>
Outgoing, gregarious, and ebullient, Carla was more puzzled than worried about her waxing and waning illness.	
dyspensia	소화불량
neurosis (neuroses: plural)	medical: an emotional illness in which a person experiences strong feelings of fear or worry
the tightening tone of a voice on the phone	
leukemia	백혈병
Leukemia is cancer of the white blood ceels - cancer in one of its most explosive, violent incarnations.	
antiseptic	소독된
I mentally rehearsed the conversation I would have with her.	
ruefully	regretfully, mournfully, sorrowfully<div>유감스럽게. 비탄에 잠겨</div>
inure	to become less affected/sensitive by something unpleasant 면역이 되다. 단련되다<div>eg) I felt I was slowly becoming inured to the deaths and desolation.</div>
desolation	extreme sadness caused by loss or loneliness
brunt	the principle force, shock, or stress
grueling	very difficult: requiring great efforts
obliterate	to destroy completely so that nothing is left<div>eg) our patients found their lives virtually obliterated by the disease</div>
Hodgkin's disease	
nihilistic n. nihilism	a viewpoint that the traditional values &amp; beliefs are unfounded and that existence is senseless and useless 허무주의의
prescient	선견지명이 있는&nbsp;<div>prescience: the ability to know what will happen in the future= foresight</div>
malignant	1. medical: very serious and dangerous<div>2. very evil</div>
indelible	impossible to remove or forget (잊을수 없는, 지워지지 않는)
kernel	seed
perseverance	인내(심)
hubris	자만심&nbsp;<div>a great or foolish amounts of pride and confidence</div>
n. suppuration / v. suppurate	to form or discharge pus
embalm	(시체에) 방부처리하다<div>to treat a dead body with special treatments to keep it from decaying</div>
listless	lacking energy or spirit<div>n. listlessness 무기력함. 노곤함</div>
groin	사타구니
combust	burn 연소하다
spleen	an organ near stomach that destroys worn-out red blood cells &amp; produce white blood cells
miasma	(지저분한, 불쾌한) 공기
cancer: uncontrollable pathological cell division	
germinate	to cause (a seed) to begin to grow 싹트다. 싹틔우다
chronic and indolent =/ acute and violent	
abyss	a deep hole (깊은 구렁)
platelet (platelets)	혈소판 (responsible for clotting blood)
finesse	skill &amp; cleverness 수완<div>eg) her treatment requires extraordinary finesse.</div>
idyosyncrasy&nbsp;	plural: idyosyncrasies<div>an unusual way in which a person behaves or thinks</div><div>an unusual part or feature or something (특이함. 이상함)</div>
He was, by nature, a quick and often impulsive thinker.	
typhoid	장티푸스
excise	1. 소비세. 소비세를 부과하다<div>2. to remove (excise cancer mass)</div>
incinerate	to burn completely
dogged	stubborn &amp; determined (반드시해내려고 하는)
lowbrow	of little taste or intellectual interest 교양없는, 저속한
exasperate	make someone very angry and annoyed<div>adj. exasperated</div>
indefatigable	지치지 않는. 포기할줄 모르는
a state-of-art facility	
scourge	1. a whip used for punishment<div>2. a person of thing that causes trouble or suffering 골칫거리. 재앙</div>
assail	attack or criticize in a violent or angry way<div>(신체적, 언어적 공격. 폭언. 폭행)</div>
conflagration	a large destructive fire
obituary	(신문에 실리는) 사망기사
outcry	a reaction/expression of strong anger or disapproval by many ppl
anemia	빈혈증
abject	1. extremely bad or severe eg) abject poverty<div>2. very humble: feeling/showing shame 비굴한</div><div>3. showing hopelessness or resignation 절망적인 eg) abject surrender</div>
folic acid	엽산
meander	1. have a lot of curves<div>2. walk slowly without a specific goal, purpose, direction</div><div>3. to go from one topic to another without direction</div>
meandering	1. curvy<div>2. 두서없이 이야기하는</div><div>3. 정처없이 거닐기</div>
reclusive	avoiding the company of other ppl&nbsp;<div>은둔하는 = solitary</div>
recluse (recluses)	a person who lives alone and avoids other ppl
serendipidous&nbsp;	우연한&nbsp;
gauntlet	1. 장갑<div>2. 시련 = a severe trial = ordeal</div>
synagogue	유대교회당
pallor	창백함 (paleness caused by illness)
Robert's condition worsened significantly. His temperature climbed higher.	
astronomically	The white cell count had climbed astronomically.
ravenous	very hungry 배가고파 죽을 지경인<div>eg) His appetite turned ravenous</div>
voracious	having tendency to eat very large amount of food 게걸스러운. 많이먹는
meticulous attention to detail	
when the storm abated	
tumultous	1. loud, excited, and emotional: 떠들썩한 (기쁜마음으로)<div>2. invoing a lot of violence, confusion, or disorder 심란한, 혼란스러운</div>
unprecedented	not done or experienced before
fulminant	coming suddenly with great severity 급격히 발병하는<div>eg) fulminant growth</div>
emblematic	상징적인
obscene	1. (sexual matter) offensive or disgusting. offensive to moral principles (repugnant)
obominable	very bad or unpleasant: causing disgust or hatred
santuary	피난처. 안식처. 보호구역
deranged	mad. insane
prognosis	예상. 예측
impotence	adj. impotent<div>1) lacking power or strength</div><div>2) unable to have sex (unable to get or keep an erection)</div>
Tuberculosis rose and ebbed throughout history.	
malevolent	1) having vicious ill will, spite, or hatred<div>2) evil or harm</div>
frenzy	광분. 광란
dropsy	수종. 부기
Cancer is age-related disease.	
biopsy	tissue 떼서 검사
autopsy	부검
epidemiological	유행병의
ratchet	조금씩 증가하다.
malignant &amp; nonmalignant tumors	
hemorrhoid	치질
boil	종기. 부스럼
apogee	정점. 절정
phlegm	가래
jaundice	황달
bile	담즙
incision	medical: 절개
unwittingly	not aware of what's happening: not intended or planned 자신도 모르는 사이에
char	burn
provocation	자극. 도발
apothecary	(과거의) 약재상
boar	수퇘지
ivory	상아
purgatives and laxatives	변비약 (loosen stools)
compulsive	caused by a desire that's too strong to resist: not able to stop or control
gargantuan	very large in size or amount<div>eg) the project became so gargantuan and complex</div>
obverse	반대
altercation	언쟁. 논쟁. 격론<div>eg) he got into an altercation</div>
babble	횡설수설하다
pout	불룩해지다<div>eg) a neat two-inch red slit in his belly, pouting open like a fish mouth</div>
anesthesiologist	마취과 의사
while the OR was readied	동사로도 쓰임
assailant	폭행범. 공격을 가한사람
aorta	대동맥
bayonet	총검
esophagus	식도
gastrectomy	위절제수술
A nurse called a code blue.	
stethoscope	
pulmonary embolism	폐색전
I was chagrined at having missed this opportunity.	
omniscient	knowing everything. 전지의
ineptitude	서투른. 기량부족. 기술부족
hypertension	고혈압
smoking cessation	중단. 중지
cardiologist	
overturn	(판결등을) 뒤집다<div>eg) two-thirds of death penalty cases are overturned because of error.</div>
stupendous	엄청나게큰, 거대한<div>eg) stupendous know-how</div>
cardiopulmonary resuscitation	CPR
dilate	커지다.<div>eg) Her pupils were dilated.</div>
maroon	고동색의. 적갈색. 밤색
bypass	1. a way that goes around a blocked/crowded area<div>2. a procedure done to 피가 heart로 통하게</div>
comatose	혼수상태인<div>eg) She lay comatose.</div>
Her speech was thick and slurry.	slurry (걸쭉한)
sterile	불임의
menagerie	a collection of animals kept especially to be shown to public
metastasis	(암세포의) 전이
immaculate	having no falw or error
cadaver	a dead body
walruse	바다코끼리
pheasant	꿩
amphitheater	원형극장. 계단식 관람석
ga'ngrenous n. gangrene	medical: 살이 decay so no blood flowing to it
antisepsis&nbsp;	소독, 방부
chrysalis	번데기= pupa
forbidding	frightening or threatening: not friendly or appealing<div>eg) The mortality following abdominal surgery was forbidding.</div>
uterine	자궁의&nbsp;<div>자궁: uterus (uterine)</div>
uterine and ovarian cancer<div>breast and prostate cancer</div>	
resect	(조직. 세포. 체내 일부) 절제하다
imbue	가득채우다. 젖게하다<div>eg) imbue the idea to the students</div><div>&nbsp; &nbsp; &nbsp; imbue it with moisture</div><div>eg) the idea of a surgeon's knife extracting cancer by its roots was imbued with promise and wonder</div>
brittle	easily broken &amp; cracked: not strong: easily damaged
combustible	1. able to be burned easily<div>2. easily excited</div>
prowess	great ability or skill<div>eg) athletic prowess</div>
recuperate	to return to normal health or strength
verve	great energy and enthusiam
quack	1. (오리) 꽥꽥 소리<div>2. 돌팔이 의사</div>
gallbladder	쓸개. 담낭
cocoon	1. 곤충의 고치<div>2. to cover or protect completely</div><div>3. to spend time at home instead of going out for other activities</div>
But Halsted and his students remained unfazed.	
aphorism	a short phrase that express a true or wise idea
incumbent on	~에게 의무인<div>eg) It is incumbent on the surgeon to perform a surgery.</div>
thyroid	갑상선
annihilate	to destroy completely: to defeat completely<div>eg) annihilate the enemy soldiers</div>
urological	비뇨기과의
pitfall	a danger/problem that's hidden or not obvious at first
whisk	1. (달걀등) 휘젓다. n. 거품기<div>2. (먼지등) 털어내다. whisk away/off</div><div>3. 홱 채어가다. 데려가다. whisk away/off/out</div>
chap	갈라지다<div>eg) My lips always chap in winter.</div>
radiation oncology	
onslaught	a violent attack 맹공격. 맹습
benediction	축복
radiation was remarkably effective at obliterating locally confined cancers.	
necrose n. necrosis	괴사하다. 괴사시키다. death of living cell<div>eg) the bones in their jaws had necresed.</div>
loot	1. (폭동. 화재시에) 훔치다. 약탈하다<div>2. 약탈자, 도둑</div><div>3. 전리품. 도난당한 전리품</div><div>eg) colonialism and its loot: catton</div>
flatulent	1. 배에 가스가 꽉찬<div>2. 허풍스런</div>
chasm	1. (바위. 땅) 깊은 틈<div>2. (생각등의) 큰 차이</div>
chemotherapy	
syphilis	매독
hypochondria	extreme depression of mind often centered on imagining physical ailments (건강에 이상이 없는데 스스로 병이 있다고 생각하는 병)
hedge	avoid giving a promise or direct answer
pugnacious	showing readiness/desire to fight or argue
Mary Woodard Laker - Albert Laker	
febrile	medical: incluidng or caused by fever
limelight	각광. 이목 (spotlight)
there was a fleeting glimpse of a cure	
ward	실 (병원)
polio	소아마비
diaphragm	횡경막
torpor	a state of not being active and having very little energy (무기력)<div>eg) Polio research was shaken out of its torpor by Franklin Roosevelt in 1937.</div>
resurgent	becoming popular, active, or successful after a period of opposite
dime	10 cent coin
spearhead	to be the leaer of
teeter	to move unsteadily (back &amp; forth or side to side)&nbsp;
cherubic	천사같은 (아이 등)
gnaw	to bite or chew
wrench	to twist and pull with a violent motion
gnawing and wrenching pain in his stomach	
appendicitis	맹장염
staggering	very large, shocking, or surprising<div>eg) the public response was staggering</div>
metamorphosis	1. major chang ein appearance or character<div>2. 변태, 탈바꿈</div>
emaciate	수척해지게하다. 여위게하다<div>adg. emaciated 여윈, 수척한</div>
inexorably	멈출수 없이. 냉혹하게, 가차없이
she will likely not survive	
decimate	to destroy or damage
scurvy	괴혈병
pellagra	니코틴 부족으로 생기는 병
convalesce	to regain health and strength gradually after sickness or illness = recuperate
convalescence	=recuperation<div>time spent recovering from an illness or medical treatment</div>
stodgy	dull and uninspired (boring)
moribund	dying, lacking vitality or vigor<div>eg) transform moribund social club into a highly organized lobbying group</div>
arthritis	관절염
unflinching	not showing fear or hesitation in the face of danger or difficulty
obscure	1. adj: not well known v: 숨기다. 감추다<div>2. adj: difficult to understand &nbsp;v: to make something difficult to understand</div>
fiat	order that must be followed &nbsp;명령. 지시
sterility	멸균율
penicillin	1928. Alexander Fleming
cardiovascular disease	
nephrology	신장학
ophthalmology	안과학
orthopedics	정형학
urology	비뇨기과학
pancreatic cancer	췌장암
hernia	탈장
flabbergast	to shock or surprise (someone) very much<div>깜짝 놀라게하다</div><div>eg) the answer flabbergasted me</div>
irate	very angery (eg) an irate taxpayer<div><br /></div>
opaque	불투명한. 이해하기힘든&nbsp;<div>eg) It's an opaque term.</div>
intensive care unit = critical care = ICU	
hemorrhage	출혈. 출혈하다
gallstone	담석
ventilator	환풍기. 산소호흡기
intravenous fluids = IV	
clammy	축축한 eg) clammy hands
He got shaking chills.	
weak and debilitated	
pediatrics	소아과
galloping heart rate	
fallibility of human memory and attention	
lull	졸리게하다. 편안하게 (안이하게) 하다.<div>eg) the music lulled him to sleep.</div>
no-brainers	
cash-strapped	금전적으로 어려운. 재정난에 처한
minutia&nbsp;	세부사항들. 상세한 내용
psychically	정신적으로
quandary	in situation where you're confused about what to do<div>진퇴양난. 곤경에 처함</div>
rancorous	characterized by bitterness and resentment
blitzkrieg	a fast &amp; powerful effort: a sudden &amp; overwelming millitary attack
consurtium	a group of ppl, companies, etc. that agree to work together
placenta	태반
obstetrician	산부인과 전문의
decoy	(사냥감 유인하기 위한) 새, 미끼
renegade	변절자, 탈당자
iconoclast	인습타파주의자
effusive	1. expressing a lot of emotion<div>2) pouring fiercely 분출하는</div><div>eg) effusive praise</div>
tingling	톡톡쏘는, 따끔거림
scour	1. to rub hard<div>2. 샅샅이 뒤지는</div>
interminable	continuing for a long time: 끝이없는 (지겹고 짜증날 정도로)<div>eg) an interminable meeting</div>
I felt awestruck.	
Hodgkin's disease = lymphoma	a cancer of the lymph glands
harbinger	something that shows what is coming (흔히 좋지않은 일이 일어날) 조짐
the annihilation of immune system	
a double-edged sword	
tout	1) to talk about (X) as being a very good, effective, etc.<div>2) to try to sell something (광고하다)</div><div>3) to buy tickets and resell them at a higher price</div>
protege	제자
no-man's-land	land that's not controlled by anyone
animus	반감. 적대감
spiral and bone marrow taps	
electrifying	super exciting
palliate &nbsp;n. palliation	to ease symptoms without curing the underlying disease
carcinogen	medical: a substance that can cause cancer
fumigate	to remove or destroy germs with smoke or gas
levitate	to rise in the air (magically)
meoplasm	tumor
lambaste	criticize very harshly
capitulate	stop fighting the enemy: to admit that an enemy has won
Bulldoggish and unwilling to capitulate, Rous lambasted the idea that XX	
cytotoxic	toxic to cells
unscathed	not hurt, harmed, or damaged
propulsion	추진, 추진력
catapult	to quickly move up or ahead to better position
seismic	1. very large or important<div>2. related to earthquake</div>
befuddle	confuse: make (someone) unable to think clearly
grouse	complain
insular	ignorant or uninterested in ideas, cultures, or peoples outside one's own experience<div>편협한, 배타적인</div>
the motion was put to a vote: 79 in favor and 1 against it	
cursory	hasty &amp; not thorough or detailed 대충의<div>eg) a cursory glance</div>
Her voice was suddenly tightened as she recognized mine.	
white noise	a constant noise that is a mixture of many different sounds
I was put on hold.	
pectoral	가슴 근육의
clavicle	쇄골
down-to-earth	informal &amp; easy to talk to
no-nonsense	simple &amp; straightforward: sensible
